BBBBBBBBBBBBBBB
BBOOOOOOOOBBBBB
BVOOOOOOOOBBBBB
BVBBBBBBBBBOOOB
BVVVVVVVVVBOOOB
BBBBVBBBBVBOOOB
BOOOOOOBBVVOOOB
BOOOOOOBBVBBBBB
BBBBBBBOOOOOOOB
BBBBBBBOOOOOOOB
BBBBBBBOOOOOOOB
BBBBBBBOOOOOOOB
BBBBBBBOOOOOOOB
BBBBBBBOOOOOOOB
BBBBBBBOOOOOOOB
BBBBBBBBBBBBBBB
